ẽd̾<EOT>	endum~
statĩ	statim
c̾t	cret
<SOT>aͩ<EOT>	~aliud~
<SOT>exͣne	~extrane
<SOT>⁊̃<EOT>	~etiam~
<SOT>ꝯcuˡᵉ	~concupuscibile
<SOT>irasciˡⁱ	~irascibili
<SOT>ipãs<EOT>	~ipsas~
<SOT>maxĩe<EOT>	~maxime~
ꝑticipacõe	participacione
phũs	philosophus
młr	mulier
potñc	potenc
regñd	regend
ꝓhibñcia	prohibencia
anͣ<EOT>	antia~
mlĩer	mulier
prohĩtio	prohibitio
dñ	dominum
dñm	dominum
encõnes<EOT>	enciones~
tacioẽs	taciones
nacõnes	naciones
h̃ẽre	habere
gnãndum	generandum
int̃łłctuales	intellectuales
intllcũales	intellectuales
<SOT>s̾ui	~serui
ctoĩs	ctionis
regim̃e	regimine
intllc̾iue	intellectiue
racioẽ	racionem
<SOT>p̃st	~praest
q̃nto	quanto
eeͣłr	essentialiter
Cõiu	Coniu
ẽd̃<EOT>	endum
ĩtllcuales	intellectuales
t̾stia	tristia
<SOT>cĩtas<EOT>	~ciuitas~
ꝑfc̃e	perfecte
coĩt̾	communiter
ꝑticłr	particulariter
regimĩ	regimini
eᷤ	es
q̃ntum	quantum
ꝯcupĩa	concupiam
itłłctu	intellectu
pͣdenͣ	prudentia
intlłciuus	intellectiuus
q̃rend̾	querendum
hõĩne	homine
p̃ced	preced
tõe<EOT>	tione
toẽ<EOT>	tione
cetẽa	cetera
aggͤdirẽ᷑	aggredirentur
intlłc̃iue	intellectiue
particła	particula
tiꝯ̃<EOT>	timus~
intllc̃iuꝰ	intellectiuus
incłia	inclina
reẜuã᷑	reseruantur
arbit̾ũ	arbitrium
<SOT>dñi	~domini
assiła	assimila
aggͥdi	aggredi
etĩa	etiam
fcõ	facto
defcũ	defectu
app̾hñsam	apprehensam
morałs	morales
rõne	rationem
intłctͥꝯ	intellectiuus
dĩnutum	diminutum
delctacioẽs	delectationes
ft̾<EOT>	fert~
<SOT>coͦs	~cognos
mĩe<EOT>	mine~
toẽs<EOT>	tiones~
cõnem<EOT>	cionem
cõnibus<EOT>	cionibus
inaĩa	inanima
c̾dunt	credunt
hr̃e	habere
hrẽ	habere
h̃re	habere
accioẽ	accione
nccͣi	neccesari
ꝯĩ	communi
dm̃ ẽ	dictum est
ce̾t<EOT>	ceret~
peᵗꝰ<EOT>	petitus~
hab̃&	habent
hñt	habent
ht̃	habet
h̃et	habent
hãt	habent
ħnt	habent
h	habet
h̃	habent
h̃nt	habent
<SOT>possiꝯ̃<EOT>	~possimus~
<SOT>difficłi	~difficili
<SOT>difficłtas<EOT>	~difficultas~
<SOT>resistiꝯ̃ <EOT>	~resistimus~
<SOT>sẜiˡⁱᵃ<EOT>	~sensibilia~
<SOT>sẜibli̾a<EOT>	~sensibilia~
<SOT>ꝯsi	~consi
<SOT>cibm̃<EOT>	~cibum~
<SOT>agͤd	~aggred
<SOT>agg̾d	~aggred
<SOT>ꝯfor	~confor
<SOT>ꝯfor̃em<EOT>	~conformem~
<SOT>tanq̃<EOT>	~tanquam~
<SOT>tãqmͣ<EOT>	~tamquam~
<SOT>tamqmͣ<EOT>	~tamquam~
<SOT>tãꝙ̃<EOT>	~tamquam~
<SOT>tamqͣ<EOT>	~tamquam~
<SOT>łui	~leui
<SOT>agñt	~agent
<SOT>uña<EOT>	~unam~
<SOT>alm̃<EOT>	~alium~
<SOT>soͫͫ<EOT>	~solum~
<SOT>dełc	~delec
<SOT>loͫ<EOT>	~locum~
lͨ	lec
<SOT>sit̃<EOT>	~sint~
<SOT>essenͣlr̃<EOT>	~essentialiter~
<SOT>eenͣłr<EOT>	~essentialiter~
<SOT>eeͣnͬ<EOT>	~essentialiter~
<SOT>essemͣ<EOT>	~essentiam~
<SOT>eẽmͣ<EOT>	~essentiam~
<SOT>eeͣm<EOT>	~essentiam~
<SOT>eẽia<EOT>	~essentia~
<SOT>ẽena<EOT>	~essentia~
<SOT>eẽnͣm<EOT>	~essentiam~
<SOT>fiãus<EOT>	~fiamus~
<SOT>poĩt᷑<EOT>	~ponitur~
<SOT>poi᷑<EOT>	~ponitur~
<SOT>opꝰ<EOT>	~opus~
<SOT>cõiu	~coniu
<SOT>cõi	~comuni
<SOT>appeᵗᵘ<EOT>	~appetitu~
<SOT>qnͣtum<EOT>	~quantum~
<SOT>qnͣtũ<EOT>	~quantum~
<SOT>ꝙͣtũ<EOT>	~quantum~
<SOT>fortiᵈᵒ<EOT>	~fortitudo~
<SOT>mansueᵈᵒ<EOT>	~mansuetudo~
<SOT>mansuᵈᵒ<EOT>	~mansuetudo~
<SOT>ꝯ̃m<EOT>	~commentatorem~
<SOT>com̃<EOT>	~commentatorem~
<SOT>manᵈᵒ<EOT>	~mansuetudo~
<SOT>cͥꝯ<EOT>	~cuius~
patebͭ	patebit
<SOT>inẽ<EOT>	inest
ałib<EOT>	animalibus~
<SOT>ałia<EOT>	~animalia~
<SOT>ali̾a<EOT>	~animalia~
deꝰ<EOT>	demus~
ãd̃<EOT>	andum~
<SOT>methaᶜᵃ<EOT>	~methaphisica~
<SOT>methᶜᵃ<EOT>	~methaphisica~
<SOT>m̃thaᶜᵃ<EOT>	~methaphisica~
<SOT>methapħica<EOT>	~methaphisica~
<SOT>neq<EOT>	~neque~
<SOT>neꝙ<EOT>	~neque~
<SOT>H̃<EOT>	~Hoc~
end̃<EOT>	endum~
<SOT>ꝯcupiscibłem<EOT>	~concupiscibilem~
<SOT>cõcupiscił<EOT>	~concupiscibilis~
<SOT>cõcuł<EOT>	~concupiscibilis~
<SOT>ꝯcupił<EOT>	~concupiscibilis~
<SOT>ꝯcupisł<EOT>	~concupiscibilis~
scił<EOT>	scibilis~
ger̾e	gerere
er̃<EOT>	ere~
<SOT>sͨ<EOT>	~sic~
iᵇ<EOT>	ibus~
bͧ	bru
<SOT>qũe<EOT>	~quem~
qũe	quen
seqũs	sequens
tamẽ	tamen
<SOT>potẽtiã<EOT>	~potentiam~
<SOT>poᵃ<EOT>	~potentiam~
<SOT>potentĩa<EOT>	~potentiam~
<SOT>pomͣ<EOT>	~potentiam~
<SOT>potissiẽ<EOT>	~potissime~
<SOT>petissiẽ<EOT>	~petissime~
<SOT>potissĩe<EOT>	~potissime~
<SOT>tam̃<EOT>	~tamen~
<SOT>ꝯput	~comput
computaͥ	computari
hom̃ibus	hominibus
hoĩb	hominibus
hoͥbus	hominibus
hoͥbꝯ	hominibus
seqñs	sequens
pot̃eᵉ	potentiae
rlãm	regulam
<SOT>etͣ<EOT>	~etiam~
<SOT>ẽt<EOT>	~etiam~
<SOT>⁊̃ <EOT>	~etiam~
pare᷑	paretur
inc̾p	increp
<SOT>ulłs<EOT>	~ullus~
<SOT>n<EOT>	~nec~
poⁱˢ	potentiis
poⁱⁱˢ	potentiis
<SOT>h᷒<EOT>	~huius~
ꝯñt	consequent
ꝯñr	consequenter
etiã	etiam
sẜĩtm̃	sensitiuum
br᷑<EOT>	bitur~
qͣ<EOT>	quam~
<SOT>simpͬ<EOT>	~simpliciter~
<SOT>sĩpͬ<EOT>	~simpliciter~
<SOT>simpłr<EOT>	~simpliciter~
Prĩo	primo
gnͣa	genera
Pͦ	Primo
queq	queque
fc̃iua	factiua
quaq	quaque
nu̾o	numero
num̾o	numero
huioĩ	huiusmodi
huiõi	huiusmodi
hmõdi	huiusmodi
hmõi	huiusmodi
<SOT>om̃i	~omni
<SOT>omĩ	~omni
Sͨ	Sic
cõest	comest
digĩt	digerit
<SOT>rͣ	~regula
fcõ	fectio
ccõe	ctione
cõe	ctione
<SOT>qtͦ<EOT>	~quot~
seꝙ̃	sequen
ꝙ̃d	quend
ꝙ̃t	quant
<SOT>ꝙ̃	~quem
<SOT>ꝯse	~conse
seqͥ<EOT>	sequi~
ꝯseꝯt᷑	consequuntur
seq̃nt	sequunt
<SOT>qm̃<EOT>	~quem~
<SOT>hõ<EOT>	~homo~
<SOT>hͦ<EOT>	~homo~
sẜĩ	sensi
d̃ic	diuic
dĩci	diuici
sẜitãs	sensitiuas
<SOT>nũo<EOT>	~numero~
tab̃r<EOT>	tabitur~
<SOT>ẜai̾e	~secundarie
<SOT>ẜã	~secunda
<SOT>ẜa	~secunda
<SOT>ind̃<EOT>	~inde~
<SOT>Iñ<EOT>	~inde~
Deiñ	Deinde
Deind̃	Deinde
tͥbꝯ	tribus
tͥb	trib
noiẽt	nominet
noĩe᷑	nominetur
noĩe	nomine
noĩa	nomina
nutͥt	nutrit
posˡᵉ	possibile
inpoˡᵉ	inpossibile
possiˡᵉ	possibilem
possiˡᵉ	possibile
poˡᵉ	possibilem
sẜitiã	sensitiuam
rõne᷑	ratiocinetur
rõcine᷑	ratiocinetur
rõcine	ratiocine
rõcin	ratiocine
rõciẽ	ratiocine
rõnet	ratiocinet
poⁱⁱˢ	potenciis
loᵈᵒ	loquendo
uͭ	ut
uid<EOT>	uidet~
tioẽ<EOT>	tione~
min᷒	minus
mĩꝯ	minus
nlłꝯ	nullus
hoͥs	hominis
hoͥb	hominibus
hõĩb	hominibus
d̾ig	dirig
di̾g	dirig
occło	occulo
<SOT>srĩ	~superi
<SOT>ordiẽ	~ordine
pp ͫ	populum
ppͫ	populum
diłcoẽ	dilectionem
tiã<EOT>	tiuam~
tĩam<EOT>	tiuam~
tĩa<EOT>	tiuam~
tiã<EOT>	tiua~
tĩa<EOT>	tiua~
tĩe<EOT>	tiue~
tiẽ<EOT>	tiue~
tiõ<EOT>	tiuo~
tĩo<EOT>	tiuo~
nd<EOT>	ndum~
<SOT>põi<EOT>	~poni~
pͥꝯ	prius
pͥꝰ 	prius
pͥus	prius
Pͥnͬ	Principaliter
<SOT>pͥnͬ<EOT>	~principaliter~
<SOT>pͥnłr<EOT>	~principaliter~
<SOT>uei̾<EOT>	~ueri~
poᵈᵃ	ponenda
ptãte	potestate
poᵗᵉ	potestate
<SOT>o<EOT>	~oportet~
<SOT>O<EOT>	~Oportet~
qbꝯ	quibus
cũꝙ	cumque
appeᵗꝰ<EOT>	appetitus~
nd̃<EOT>	ndum~
ĩt̾<EOT>	inter~
int̃<EOT>	inter~
fac̃	facit
face̾	facere
ob̃m	obiectum
<SOT>obõ<EOT>	~obiecto~
<SOT>ob̾o<EOT>	~obiecto~
<SOT>obiͨto<EOT>	~obiecto~
ti᷒	tibus
<SOT>tͥstiͣ<EOT>	~tristitia~
tͥ<EOT>	tri~
tͥs	tris
tõi	tioni
<SOT>dc̃m<EOT>	~dictum~
<SOT>Dcm̃<EOT>	~dictum~
<SOT>dcm̃<EOT>	~dictum~
<SOT>dc̃<EOT>	~dictum~
<SOT>respic̃	~respicit
<SOT>fug̃	~fugit
<SOT>fuĩt<EOT>	~fugiunt~
<SOT>ob̃o<EOT>	~obiecto~
<SOT>gna̾	~genera
<SOT>ag̃<EOT>	~agit~
ꝑfect̃or	perfectior
uidelz	uidelicet
uidel	uidelicet
ui	uidelicet
<SOT>ałi	~animali
<SOT>calidiᵗᵉ<EOT>	~caliditatem~
<SOT>caliᵗᵃˢ<EOT>	~caliditas~
<SOT>całi	~calidi
aĩat	animat
<SOT>sũ<EOT>	~siue~
siũ<EOT>	siue~
<SOT>pħm<EOT>	~philosophum~
<SOT>phõs<EOT>	~philosophos~
<SOT>phm̃<EOT>	~philosophum~
<SOT>ph̃m<EOT>	~philosophum~
<SOT>pħia<EOT>	~philosophia~
<SOT>ph̃ia<EOT>	~philosophia~
<SOT>phĩa<EOT>	~philosophia~
<SOT>phͥia<EOT>	~philosophia~
<SOT>geomeͣ<EOT>	~geometria~
<SOT>geometͥ<EOT>	~geometria~
qz<EOT>	que~
<SOT>d̃<EOT>	~de~
<SOT>hͥ<EOT>	~hic~
<SOT>quæcun<EOT>	~quaecunque~
<SOT>quecumq<EOT>	~quecumque~
<SOT>q̃cũq<EOT>	~quaecumque~
<SOT>q̃ꝯ<EOT>	~quaecumque~
<SOT>quecuq<EOT>	~quecumque~
pͣt	prat
hi᷒	huius
<SOT>hũ<EOT>	~huius~
p᷒s	poss
bai̾	bari
puta̾	putari
<SOT>pͣctico	~practico
u̾s	uers
sinʳ	singulariter
singłr	singulariter
singlr̃	singulariter
boĩs	bonis
boĩt	bonit
noƀ	nobis
nob̃	nobis
<SOT>nb̃<EOT>	~nobis~
o̾a	ora
<SOT>⁊cͣ<EOT>	~etcaetera~
<SOT>c̃<EOT>	~caetera~
<SOT>nͦ<EOT>	~non~
sñꝑ	senper
<SOT>ñõ<EOT>	~non~
<SOT>uniu̾	~uniuer
seqt᷑	sequitur
sequi᷑	sequitur
i᷑	itur
pot̃a	potesta
<SOT>omĩs<EOT>	~omnis~
<SOT>õe<EOT>	~omne~
bz<EOT>	bus~
sẜn	sens
ꝯũi	communi
coĩ	communi
cõĩ	communi
sẜ	sensum
debñt	debent
<SOT>exñt<EOT>	~existent~
<SOT>exñtes<EOT>	~existentes~
<SOT>exñteᷤᷤ<EOT>	~existentes~
<SOT>entẽ<EOT>	~existentem~
tĩs<EOT>	tiuis~
ueĩ	ueni
ꝓpͥ	propri
t̾r	terr
xi᷒	ximus
<SOT>pret̾<EOT>	~preter~
<SOT>p̃t̾<EOT>	~praeter~
<SOT>p̃ter<EOT>	~praeter~
<SOT>p̃te	~praete	
<SOT>p̾sens<EOT>	~praesens~
<SOT>pñs<EOT>	~praesens~
<SOT>p̃sens<EOT>	~praesens~
<SOT>pła	plura
<SOT>płi	~pluri
<SOT>płes<EOT>	~pluries~
<SOT>tcͣta	~tracta
<SOT>eĩ<EOT>	~enim~
<SOT>enĩ<EOT>	~enim~
<SOT>eͥ<EOT>	~enim~
<SOT>em̃<EOT>	~enim~
<SOT>eni<EOT>	~enim~
<SOT>pp̃<EOT>	~propter~
<SOT>ꝑꝑ<EOT>	~propter~
<SOT>ꝑp<EOT>	~propter~
<SOT>ꝓp̃<EOT>	~propter~
d̾<EOT>	dum~
der̃<EOT>	dere~
qͣn	quan
qͣs	quas
<SOT>sͭ<EOT>	~sunt~
pñt	possunt
<SOT>post̃<EOT>	~possunt~
<SOT>pũt<EOT>	~possunt~
c᷒modi	cuiusmodi
c᷒mõ	cuiusmodi
<SOT>u̾łi	~uniuersali
<SOT>ułi	~uniuersali
<SOT>m̃di	~medi
<SOT>meͤ<EOT>	~medie~
<SOT>c᷒moͥ<EOT>	~cuiusmodi~
<SOT>sꝑ<EOT>	~semper~
exñs	existens
gm̃tat	gmentat
gm̃t	gmentat
<SOT>aͥqͥ	~aliqui
<SOT>qũ<EOT>	~quando~
<SOT>qñ<EOT>	~quando~
<SOT>regͣt	~regnat
<SOT>scẽ	~sancte
<SOT>sc̃e	~sancte
<SOT>tc̃<EOT>	~tunc~
<SOT>iͣ<EOT>	~ita~
feliciͭᵗᵉ	felicitatem
ciͭᵗᵉ	citatem
uoᵗᵉ	uoluntatem
<SOT>caⁱᵗᵉ<EOT>	~caritate~
<SOT>ꝓͭ<EOT>	~prout~
<SOT>aͥd<EOT>	~aliquid~
tiꝯ̃ <EOT>	tiuus~
gn̾	gener
pĩꝯ	pimus
ĩꝯ	iuus
regm̃b	regiminibus
regiẽ	regimine
iãcõ<EOT>	inacio~
nac̃o<EOT>	nacio~
nacõ<EOT>	nacio~
regĩe	regimine
<SOT>ẽ<EOT>	~est~
scdõ	secundo
<SOT>ẜ<EOT>	~secundum~
<SOT>ẜm<EOT>	~secundum~
<SOT>ẜ<EOT>	~secundum~
<SOT>Scd̾m<EOT>	~secundum~
qñs<EOT>	quens~
scd̃m	secundum
scdm̃	secundum
diliᵗᵉˢ	diligentes
uᷤ<EOT>	us~
enͤ<EOT>	entie~
hiꝰ	huius
cũ᷑<EOT>	cuntur~
<SOT>ꝓseꝯt	~prosequunt
<SOT>ꝓseqͣ	~prosequa
pisꝯt᷑<EOT>	piscuntur~
<SOT>mag̾<EOT>	~magis~
<SOT>ag̃t<EOT>	~agunt~
<SOT>tł	~tal
<SOT>p<EOT>	~patet~
h̃eant	habeant
hẽat	habeat
apũ<EOT>	apud~
ꝯnr̃	consequenter
p̃tax	praetax
p̃ta	potesta
potãt	potestat
<SOT>pot̃<EOT>	~potest~
sb̃t	subt
tiłr	tiliter
<SOT>quõ<EOT>	~quomodo~
<SOT>Quõ<EOT>	~Quomodo~
c̾sc	cresc
ẽ¬	en¬
eiusmõ	eiusmodi
<SOT>liͥ<EOT>	~libri~
<SOT>libͥ<EOT>	~libri~
<SOT>libꝵ<EOT>	~librum~
az<EOT>	am~
ez<EOT>	em~
<SOT>etħ<EOT>	~ethicorum~
<SOT>eth̃<EOT>	~ethicorum~
<SOT>moraᵇꝰ<EOT>	~moralibus~
<SOT>moraᵇ<EOT>	~moralibus~
ethiꝵ	ethicorum
libͫ	librum
sr̾	super
sr̃	super
c᷑	cur
blĩt	bilit
<SOT>ł<EOT>	~uel~
<SOT>s<EOT>	~sed~
<SOT>S<EOT>	~Sed~
<SOT>pt̃at	~potestat
ꝙ̃d	quend
bñe	bene
bnẽ	bene
bñ	bene
ꝯu̾	conuer
sẜitĩm	sensitiuum
<SOT>hnͣc<EOT>	~hanc~
<SOT>nãm<EOT>	~naturam~
<SOT>nͣl	~natural
<SOT>n᷑al	~natural
<SOT>nͣlr̃	~naturaliter
Natͣ	Natura
<SOT>nͣ<EOT>	~natura~
<SOT>nͣłr<EOT>	~naturaliter
<SOT>nͣł<EOT>	~naturalis~
<SOT>boͣ<EOT>	~bona~
boͣm	bonam
boã	bonam
błi	bili
sb̾	sibi
gꝰ	gus
sic̾	sicut
tiꝰ	tiuus
<SOT>delc̃aˡⁱᵃ<EOT>	~delectabilia~
<SOT>delcãbłia<EOT>	~delectabilia~
<SOT>delectaˡⁱᵃ<EOT>	~delectabilia~
<SOT>delcãbłia<EOT>	~delectabilia~
<SOT>delectaˡᵉ<EOT>	~delectabile~
<SOT>delc̃atõm<EOT>	~delectationem~
<SOT>delectacõm<EOT>	~delectacionem~
<SOT>delc̃atõib<EOT>	~delectationibus~
<SOT>delectaᵇꝰ<EOT>	~delectationibus~
<SOT>delc̃a	~delecta
<SOT>delectacõnibus<EOT>	~delectationibus~
<SOT>delcãbłe<EOT>	~delectabile~
ciˡᵉ<EOT>	cibile~
ciˡᵉ<EOT>	cibilem~
cibłẽ<EOT>	cibilem~
ciˡᵉ̃ <EOT>	cibilem~
accipr̃	accipitur
<SOT>ac̃ens	~accidens
accñs	accidens
id̃	idem
iꝯt	icunt
i᷒tiͣ	iustitia
iustiͣ	iustitia
iustĩa	iustitia
i᷒ticia	iusticia
i᷒titia	iustitia
sẜitiꝯ̃ 	sensitiuus
sensit̃s	sensitiuus
<SOT>inteͧ<EOT>	~intellectu~
<SOT>inlłctu<EOT>	~intellectu~
intlłctuᵇꝰ	intellectualibus
intlłc̃ualib	intellectualibus
intllt̃uales	intellectuales
intellectuˡᵉˢ	intellectuales
intellects̃	intellectiuus
intlłc̃iuus	intellectiuus
intłlc̃us	intellectus
<SOT>inteꝰ<EOT>	~intellectus~
intlłcm	intellectum
ĩtelłctiu᷒	intellectiuus
ĩtllcĩua	intellectiua
ĩtlłcm	intellectum
intłłu	intellectu
intlłit	intellectit
intlłtm̃	intellectum
intelłctuałs	intellectuales
intlłm	intellectum
intłłm	intellectum
intłłct	intellect
intlłct	intellect
ĩtłłct	intellect
intłlect	intellect
ĩtlłu	intellectu
intlłu	intellectu
intlłc	intellec
int̃lłctu	intellectu
intlłctuałs	intellectuales
intelłctu	intellectu
ĩtllem	intellectem
ĩtllcũ	intellectu
intłlectu	intellectu
ĩtlłos	intellectos
ĩtlłe	intelle
ĩtlłc	intellec
ĩtllc̃s	intellectus
ĩtlleũ	intellectum
ĩtllc̃	intellect
Intllcũs	Intellectus
intllcũs	intellectus
intlłectu	intellectu
ĩtllcĩuꝰ	intellectiuus
ĩtllciuꝰ	intellectiuus
ĩtllc̃iuꝰ	intellectiuus
ĩtllc̃s	intellectus
ĩtlłcũ	intellectum
intllc̃m	intellectum
intlłcu	intellectu
incłłm	intellectum
intllcm̃	intellectum
itlłctu	intellectu
intllcũ	intellectum
ĩcłłm	intellectum
llcĩo	llectiuo
pͧdenͣ	prudentia
prudenͣ	prudentia
tenperanͣ	tenperantia
specła	specula
tͥa	tria
sunpͣ	sunper
cła	clara
cłi	clari
ngła	ngula
<SOT>gła	~gloria
<SOT>sñt<EOT>	~sunt~
<SOT>st̃<EOT>	~sunt~
<SOT>aũ<EOT>	~autem~
<SOT>autẽ<EOT>	~autem~
<SOT>aͧtem<EOT>	~autem~
<SOT>ãt<EOT>	~autem~
<SOT>a̾<EOT>	~autem~
<SOT>aͭ<EOT>	~autem~
<SOT>aũt<EOT>	~autem~
<SOT>at̃<EOT>	~autem~
at̃<EOT>	ant~
<SOT>maĩ	~mani
ꝑfcõis	perfectionis
ꝑfcĩo	perfectio
ꝑfc̃ora	perfectiora
ꝑfect̃orͣ	perfectiora
cõm<EOT>	cionem~
<SOT>cõm	~comm
łx	lex
itaq	itaque
<SOT>itaq<EOT>	~itaque~
iᷤ<EOT>	is~
hibñc	hibenc
lłe	llere
<SOT>sił<EOT>	~similiter~
<SOT>oñd̾e<EOT>	~ostendere~
<SOT>oñdentes<EOT>	~ostendentes~
<SOT>oñs	~ostens
<SOT>hẽre<EOT>	~habere~
<SOT>h̃re<EOT>	~habere~
<SOT>tẽdͭ<EOT>	~tendit~
q̊	quo
qͦ	quo
n̾<EOT>	nere~
pp̃o	prioprio
<SOT>d̃b	~deb
<SOT>d̃<EOT>	~debent~
<SOT>d<EOT>	~debet~
<SOT>dec<EOT>	~decet~
poͤ<EOT>	potentiae~
<SOT>nͣm<EOT>	~naturam~
naͣl	natural
naͣ	natura
n᷑a	natura
blĩa	bilia
<SOT>cĩl	~ciuil
<SOT>qũo<EOT>	~quomodo~
<SOT>sͥ<EOT>	~sibi~
<SOT>sb̃<EOT>	~sibi~
<SOT>sibͥ<EOT>	~sibi~
płn	plen
błe	bile
<SOT>aiã	~anima
<SOT>aĩa	~anima
<SOT>aĩe<EOT>	~anime~
aiãt	animat
c̾e<EOT>	cere~
aͥqͥ	aliqui
qͦt	quot
baͥ	bari
qĩ	quasi
qiͣ	quasi
qͣi	quasi
\.q\.	quasi
\.n\.	enim
u̾ͥtut	uirtut
U̾tu	Uirtu
<SOT>tlĩ	~tali
uͥtu<EOT>	uirtu~
deẜ	deser
de	deser
<SOT>pͣ	~prima
<SOT>frigiᵗᵃˢ<EOT>	~frigiditas~
<SOT>frĩdi<EOT>	~frigiditas~
<SOT>gͣuiᵗᵉ̃	~grauitatem
<SOT>fr̃i	~frigi
<SOT>fͥgi	~frigi
d̃t<EOT>	dunt~
dt̃<EOT>	dunt~
ũtut	uirtut
<SOT>oĩ	~omni
t̾mĩe	termine
t̾ia	termina
det̾m̃a	determina
det̾i	determi
<SOT>ꝓhibẽ<EOT>	~prohibere~
<SOT>ꝓibẽtiͣ<EOT>	~prohibentia~
hib̃e<EOT>	hibere~
<SOT>ꝓhibñ	~prohiben
<SOT>ꝓhĩ	~prohibi
<SOT>ꝓh̃i	~prohibi
frĩt	frigidit
h̃itos	habitos
h̃itus	habitus
ħitus	habitus
mõĩ<EOT>	modi~
mõi<EOT>	modi~
moĩ<EOT>	modi~
ethiꝵ	ethicorum
ethꝵ	ethicorum
eth̃<EOT>	ethicorum
sũꝯ	sumus
Scd̾o	Secundo
scd̃o	secundo
Scd̃o	Secundo
S̾o	Secundo
ẜo	secundo
uai̾a	uaria
oĩb	omnibus
T̃cio	Tercio
Q̾r	Quare
<SOT>qͣre<EOT>	~quare~
<SOT>qr<EOT>	~quia~
<SOT>q̃r<EOT>	~quare~
<SOT>Q̃r<EOT>	~Quare~
<SOT>Qr̃<EOT>	~Quare~
<SOT>hĩt	~habit
<SOT>pͧ	~pru
hꝯͥ	huius
a᷑<EOT>	atur~
n᷑al	natural
sentẽ<EOT>	sententia~
aꝵ	arum
oꝵ	orum
młto	multo
<SOT>forͣm<EOT>	~formam~
<SOT>formͣ<EOT>	~formam~
<SOT>forͣm<EOT>	~formam~
<SOT>forᵃ<EOT>	~formam~
<SOT>forͣ<EOT>	~formam~
<SOT>foͣm<EOT>	~formam~
specł	specul
mag̃	magis
app̃h	appreh
ap̃p̃h	appreh
app̾h	appreh
app̃	appre
sensꝯ	sensus
<SOT>se᷑<EOT>	~sequitur~
<SOT>seq᷑<EOT>	~sequitur~
<SOT>seqr᷑<EOT>	~sequitur~
appeͫ	appetitum
qmͣ	quam
<SOT>ꝙͫ<EOT>	~quantum~
supͣ	supra
ꝙͣ	quam
ꝙͥ	quid
<SOT>qd̃<EOT>	~quod~
ꝙ	quod
<SOT>ĩ<EOT>	~in~
qͥ	qui
end̾<EOT>	endum~
ẽd<EOT>	endum~
tõe	tione
łc	lec
eiꝰ	eius
ull̾s	ullus
nꝰ	nus
beͣ<EOT>	bentia~
be̾<EOT>	bere~
ꝓpͥa	propia
ipͣ	ipsa
ip̃e	ipse
ip̃m	ipsum
<SOT>seipĩs	~seipsis
<SOT>seip̃is	~seipsis
<SOT>ipĩs	~ipsis
<SOT>ip̃is	~ipsis
<SOT>ip̃i	~ipsi
ẽẽ	esse
eẽ	esse
ẽe	esse
u̾t	uirt
nͨ	nec
tõm	tionem
<SOT>cꝯͥ<EOT>	~cuius~
<SOT>sciĩs<EOT>	~scientiis~
<SOT>sc̃iis<EOT>	~scientiis~
<SOT>scĩe<EOT>	~scientiae~
<SOT>sc̃ie<EOT>	~scientiae~
<SOT>d̃r	~dicitur
dr̃	dicitur
<SOT>dͬ<EOT>	~dicitur~
<SOT>dñr<EOT>	~dicuntur~
<SOT>dũr<EOT>	~dicuntur~
<SOT>dr̾<EOT>	~dicitur~
an᷑	antur
Ĩ	In
g̾et<EOT>	geret~
ag̾g̾	aggre
cet̾a	cetera
<SOT>ꝯͥe	~conuenie
taĩ<EOT>	tari~
<SOT>ꝯͥ	~communi
ꝯm	comm
tꝰ	tus
tꝯ	tus
boꝰ	bonus
boꝯ̃<EOT>	bonus~
tͥpliͬ	tripliciter
tͥpłr	tripliciter
t̾ͥpłr̃	tripliciter
tͥpͬ	tripliciter
damͬ<EOT>	damur~
demͬ<EOT>	demor~
<SOT>boñ<EOT>	~bonum~
boͫ	bonum
hꝰ	huius
tõe	tione
ꝑ᷑	peratur
gg̾d	ggred
gi̾	geri
gei̾t	gerit
inc̾	incre
g̾	ger
coẽ<EOT>	cionem~
<SOT>pͭ<EOT>	~potest~
pt̃	potest
d̾o	deo
d̾	der
end̾	endus
t᷑	tur
uͥt	uirt
lc̃a	lica
sẜu	sensu
sẜi	sensi
sẜa	sensa
sẜꝯ	sensus
tũ<EOT>	tum~
<SOT>oñd	~ostend
<SOT>oñd̃e<EOT>	~ostendere~
poñ	ponen
Terc̃o	Tercio
lr̃	liter
łr	liter
sic̃	sicut
<SOT>Na̾̃<EOT>	~nam~
<SOT>nã<EOT>	~nam~
<SOT>ꝯn	~con
<SOT>cognitõ	~cognitio
<SOT>cognicõ	~cognicio
<SOT>ꝯgͥcõne	~cognicione
<SOT>cognitõm<EOT>	~cognitionem~
<SOT>ꝯgͦm<EOT>	~cognitionem~
<SOT>cogͦm<EOT>	~cognitionem~
cogͦsc	cognosc
cogͦs	cognosc
cogͦ	cognitio
tõ	tio
h̃eat	habeat
hñtia	habentia
h̃ncia	habentia
boña	bonna
ap̃hen	aprehen
elem̃tis	elementis
ełis	elementis
ꝓpͥa	propia
p̾tax	praetax
p̾t	praet
ꝓ	pro
<SOT>pͦ<EOT>	~pro~
<SOT>mĩs	~minis
<SOT>uo̾<EOT>	~ueros~
<SOT>uõ<EOT>	~uero~
<SOT>u̾i<EOT>	~ueri~
u̾o	uero
vͦ	vero
aᷤ<EOT>	as~
a̾<EOT>	as~
<SOT>ꝯͣ	~contra
<SOT>ꝯtͣ	~contra
<SOT>ꝯiͣ	~contrari
<SOT>ꝯͣr	~contrar
<SOT>contͣr	~contrar
oꝑt	oport
ꝑse	perse
ꝑs	pars
ꝑt	part
ꝑ	per
u᷒	uus
i᷒	ius
bꝰ	bus
b	bus
t᷒	tus
pꝰea	postea
pꝰ	pos
iuꝰ	iuus
iꝰti᷑	iustitia
pͣdenͣ	prudentia
tẽꝑanͣ	temperantia
sẜͫ	sensum
t̃m	tam
<SOT>tñ<EOT>	~tamen~
sẜm	sensum
sẜ	sens
iꝰ	ius
mͦ	modo
<SOT>mõ<EOT>	~modo~
gͣn	gnan
gͣm	gnam
mꝰ	mus
m̃ta	menta
ñ	non
<SOT>gͥ<EOT>	~igitur~
<SOT>igr̃<EOT>	~igitur~
Igͣ	Igitur
gͥ	gni
m᷑	mur
uidel	uidelicet
s᷒	sus
uł	uel
ip̃o	ipso
hr̾e	habere
hr̃e	habere
<SOT>gũi	~graui
gͣu	grau
<SOT>sͣ<EOT>	~supra~
gͦs	gnos
ꝯp	comp
ꝯc	conc
m᷒	mus
n̾	ner
ꝯd	cond
eᷤ<EOT>	es~
br̃	bitur
l	licet
lic	licet
ip̃a	ipsa
ipã<EOT>	ipsa~
e ᷤ<EOT>	es~
p̾n	prin
pͥn	prin
pͥm	prim
ppłum	populum
ppłm	populum
occłs	occulus
occłꝯ	occulus
uob̾	uobis
ut̃	unt
tꝰ	tus
Sic̃	Sicut
sic̃	sicut
sũt	sunt
qͣm	quam
poᷤ	pos
<SOT>qͣ	~qua
<SOT>Qͣre<EOT>	~Quare~
<SOT>Qͣr<EOT>	~Quare~
qͣr	quare
<SOT>qr̃<EOT>	~quare~
<SOT>qrͣ<EOT>	~quare~
<SOT>qͣre<EOT>	~quare~
iẽn	inen
miẽt	minent
uic̃o	uicio
uicõ	uicio
na᷑	natura
<SOT>d̃o<EOT>	~deo~
<SOT>dõ<EOT>	~deo~
ł<EOT>	lis~
T̾	Ter
<SOT>&<EOT>	~et~
<SOT>⁊<EOT>	~et~
&<EOT>	et~
t̾t	trit
t̾	ter
ne̾	nere
<SOT>s̃<EOT>	~supra~
du<EOT>	dum~
<SOT>dm̃<EOT>	~deum~
po ͤ<EOT>	potentiae~
poᵃˢ	potentias
potenⁱˢ	potentiis
poͤ<EOT>	potentiae~
poᵉ<EOT>	potentiae~
poͣ<EOT>	potentia~
poͣs<EOT>	potentias~
<SOT>tͥp	~trip
poͣm<EOT>	potentiam~
nͣa	natura
pole̾	polere
de̾	dere
S̃t	Sunt
De ind̾<EOT>	deinde~
Na	Nam
<SOT>na	~nam
<SOT>p̃t<EOT>	~potest~
<SOT>põt<EOT>	~potest~
oclõꝵ	oculorum
ocłs	oculus
rõnb	rationib
<SOT>rõnẽ<EOT>	~rationem~
<SOT>rõ<EOT>	~rationem~
<SOT>rõnem<EOT>	~rationem~
<SOT>ronẽ<EOT>	~rationem~
<SOT>rõm<EOT>	~rationem~
<SOT>rom̃<EOT>	~rationem~
<SOT>r̃om<EOT>	~rationem~
<SOT>roẽ	~ratione
<SOT>rõe<EOT>	~ratione~
<SOT>rõne<EOT>	~ratione~
<SOT>rõnibus<EOT>	~rationibus~
<SOT>rõi<EOT>	~rationi~
<SOT>rõni<EOT>	~rationi~
<SOT>r̃onis<EOT>	~rationis~
<SOT>rõnis<EOT>	~rationis~
t̃e<EOT>	tem~
<SOT>rõis<EOT>	~rationis~
<SOT>roĩ<EOT>	~rationi~
<SOT>roĩs<EOT>	~rationis~
<SOT>rõĩs<EOT>	~rationis~
<SOT>rõa	~rationa
<SOT>rõna	~rationa
<SOT>Rõnal	~rational
<SOT>rõ<EOT>	~ratio~
<SOT>rõe	~ratione
<SOT>rõi	~rationi
<SOT>rõˡᵉˢ<EOT>	~rationales~
n<EOT>	nem~
<SOT>mag̃<EOT>	~magis~
<SOT>mãg<EOT>	~magis~
<SOT>ocło	~oculo
regła	regula
<SOT>rmͣ<EOT>	~regulam~
<SOT>ssͫ<EOT>	~sensum~
<SOT>ss᷒<EOT>	~sensus~
ss᷒	sensus
erͣt	erat
morͣ	mora
<SOT>homiẽs<EOT>	~homines~
<SOT>hoĩes<EOT>	~homines~
<SOT>hõi	~homini
<SOT>homĩs<EOT>	~hominis~
<SOT>homĩe<EOT>	~homine~
<SOT>hoĩe<EOT>	~homine~
<SOT>hoĩ	~homini
<SOT>hoͥe	~homine
<SOT>tm̃<EOT>	~tantum~
caꝰ<EOT>	camus~
talᵇꝰ<EOT>	talibus~
taliͣ	talia
<SOT>ꝯg	~cog
p̾tͬ	praeter
<SOT>c̾<EOT>	~caetera~
p̾ter	propter
ssꝰ	sensus
nlłs	nullus
gͦ	ergo
b̾e	bere
<SOT>ã<EOT>	~autem~
ã<EOT>	am~
ũ<EOT>	um~
ẽ<EOT>	em~
ũ	un
ẽ	en
õi	omi
õ	on
miã	mina
ã	an
<SOT>dĩ<EOT>	~dei~
<SOT>d̃i<EOT>	~dei~
<SOT>d̃m<EOT>	~deum~
dĩe	dine
ĩe	iue
oĩ<EOT>	oni~
ĩ	in
f̾	fer
<SOT>uͦ<EOT>	~uero~
iss	isset
q̃	que
ꝗd	quid
ꝗ	qui
nͥ	nisi
<SOT>ꝯt	~cont
a<EOT>	am~
e<EOT>	em~
u<EOT>	um~
uz<EOT>	um~
re̾<EOT>	rere~
\.	. 
¶	<ø>
‸	<ø>
<SOT>tͣ	~tra
nͣc	nanc
pugnͣ	pugnan
p᷒	pus
<SOT>ꝯu	~conu
bꝯ	bus
õꝯ	onus
eꝯ	eius
iꝯ	ius
ꝯsc	consc
sꝰ	sus
<SOT>ħ<EOT>	~hoc~
<SOT>h̃<EOT>	~hoc~
<SOT>dup̽<EOT>	~duplex~
<SOT>dupłx<EOT>	~duplex~
<SOT>du̽<EOT>	~duplex~
<SOT>d̽<EOT>	~duplex~
<SOT>dupᶜᵉ<EOT>	~duplicem~
<SOT>duᶜᵉ<EOT>	~duplicem~
Qͥdam	Quidam
Dup̽	Duplex
morał	moralis
cał	calid
fact̃ia	factiua
<SOT>s<EOT>	~scilicet~
er<EOT>	eret~
ss<EOT>	sset~
et̃<EOT>	ent~
quid<EOT>	quidam~
modᷤ	modus
mod<EOT>	modum~
mͦ<EOT>	modum~
łs<EOT>	les~
ᵇꝰ<EOT>	bus~
cͣ	caetera
ꝓͣ	proba
ꝭ<EOT>	is~
ẜͫ	secundum
ẜm̃	secundum
scd̃	secundum
cõn	ction
<SOT>Tert̃o<EOT>	~Tertio~
<SOT>tͦ<EOT>	~Tertio~
qued	quedam
qued̃	quedam
<SOT>qͤ<EOT>	~quae~
quaed	quaedam
qͣt	quat
ꝯ<EOT>	us~
ẜ	ser
<SOT>nͣ	~natura
ᵗᵉ<EOT>	tatem~
ᵗᵉ̃ 	tatem
ᵗᵉ<EOT>	tate~
ꝰ<EOT>	us~
<SOT>młi	~muli
<SOT>p̃cep	~praecep
<SOT>p̃ced	~preced
<SOT>p̾ced	~preced
<SOT>głia	~gloria
<SOT>glia̾	~gloria
<SOT>pli̾m	~plurim
<SOT>ꝯ̃i	~comuni
<SOT>ꝯi	~coni
<SOT>ꝯs	~cons
<SOT>ncc̃it	~neccesit
płi	pluri
ce̾<EOT>	cere~
<SOT>fem̃s<EOT>	~feminis~
<SOT>r̃on	~ration
scd̃i	secundi
agr᷑	agitur
regim̃	regimen
regim̃e	regimine
regimi̾e	regimine
<SOT>descͥ	~descri
<SOT>ex̾	~exer
quom̃o	quomodo
Capłm	Capitulum
sec̾ta	secreta
pat	patet
pr̃n	patern
<SOT>nr̃a<EOT>	~nostra~
<SOT>q<EOT>	~quod~
rͦis	rationis
intlłi	intelli
<SOT>pr̃	~pater
<SOT>p̃r	~pater
<SOT>p̾es	~praes
<SOT>p̃esse	~praesse
n᷑ã	naturam
un᷑<EOT>	untur~
cõem	ctionem
pedienͣ	pedientia
perfcionẽ	perfectionem
<SOT>ẽa<EOT>	~eam~
<SOT>ap̃<EOT>	~apud~
<SOT>feĩa<EOT>	~femina~
<SOT>pħs<EOT>	~philosophus~
dim̾<EOT>	dimur~
<SOT>f<EOT>	~secundum~
<SOT>c̾d	~cred
<SOT>comunit̃<EOT>	~comuniter~